~~~~~~~~~~~~~
~~~~~~~~SSS~~
---------K-- 
           - 
A--- ----- - 
   ┌-┘   └-- 
B--- -- --   
      ┌-┐    
C------ ---- 
 ========--- 